AUTHOR: Tordarus
################
#              #
#              #
#              #
#              #
#              #
#              #
#              #
#              #
#              #
#              #
################
L 5 3 2 0
X 10 8 3 #ff0000
M 1
