{"name": "Weiss", "hint": "Erstelle einen komplett weissen Laser", "author": "Timon Ringwald"}
################
#      ##      #
#      ##      #
#      ##      #
#              #
#              #
#              #
#              #
#      ##      #
#      ##      #
#      ##      #
################
L 2 2 1 0
A 13 2
A 13 9
A 2 9
M 7
