AUTHOR: ttimpe
################
#              #
#   #######    #
#   #          #
#   #          #
#   #######    #
#         #    #
#         #    #
#   #######    #
#              #
#              #
################
L 1 1 2 0
L 1 10 1 1
L 13 1 2 1
L 13 10 0 0
X 7 6 3 1 0
M 2
P 2
A 1 7