{"name": "Mehrere Farben", "hint": "Der Receiver muss mit der richtigen Laserfarbe angesprochen werden", "author": "Timon Ringwald"}
################
######    ######
######    ######
######    ######
#              #
#              #
#              #
######    ######
######    ######
######    ######
######    ######
################
L 7 1 2 0
L 9 9 3 1
X 2 5 1 #00ff00
X 13 5 3 #ff0000
M 2
