{"name": "Mehrere Farben mischen", "hint": "Prismen können auch Laserstrahlen aus anderen Prismen mischen", "author": "Tobias Timpe"}
################
#              #
#   #######    #
#   #######    #
#   #######    #
#   #######    #
#       ###    #
#       ###    #
#       ###    #
#              #
#              #
################
L 1 10 0 0
L 13 10 0 1
L 14 1 2 2
X 5 7 1 #ffffff
M 4
P 2
