{"name": "Easy Peasy", "hint": "Denk an die mehreren Portal-Ausgänge.", "author": "Fabian Marcel Küppers"}
################
#              #
#              #
#   #          #
#   #          #
#              #
#        #######
#              #
#              #
#              #
#              #
################
L 1 3 1 0
L 1 7 2 1
X 14 2 3 #ffff00
X 13 9 0 #00ff00
P 1
M 3
PL-I #ff0000
PL-O 2 #ff0000
