{"name": "Third level", "hint": "Mit dem Prisma kannst du zwei Laser mischen.", "author": "Stefan Wiebe"}
################
################
####        ####
####        ####
####        ####
####        ####
####        ####
####        ####
####        ####
####        ####
################
################
L 5 3 2 0
A 8 5
X 10 8 0 #ff0000
M 2
