{"name": "Weiß", "hint": "Erstelle einen komplett weißen Laser", "author": "Tobias Timpe"}
################
#              #
#   #######    #
#   #          #
#   #          #
#   #####      #
#       #      #
#       #      #
#              #
#              #
#              #
################
L 1 10 0 0
L 14 10 0 1
L 14 1 2 2
X 3 7 1 #ffffff
M 2
P 2
