AUTHOR: ttimpe
################
#              #
#   #######    #
#   #          #
#   #          #
#   #######    #
#         #    #
#         #    #
#   #######    #
#              #
#              #
################
L 1 1 2 1
L 13 1 2 0
L 13 10 3 0
X 7 6 3 #ff7f00
M 10
P 2
A 1 7