{"name": "Beidseitige Spiegel", "hint": "Spiegel können Laser beidseitig reflektieren und umlenken.", "author": "Stefan Wiebe"}
################
################
##           ###
######    ######
######    ######
##           ###
##           ###
##           ###
#####    #######
#####    #######
##           ###
################
L 2 2 1 0
L 12 10 3 1
X 2 6 1 #ff0000
X 12 6 3 #00ff00
M 3
